shihali	nobin_boy_name
nabra	nobin_girl_name
medetongnon	benin_boy_name
majdolên	nobin_girl_name
sela	nobin_girl_name
yénukunmin	benin_girl_name
daria	nobin_girl_name
duwana	nobin_girl_name
sâlah	nobin_boy_name
winji	nobin_girl_name
mondoukpè	benin_girl_name
gbogblenou	benin_girl_name
osha	nobin_girl_name
oshi	nobin_boy_name
amaros	nobin_girl_name
umar	nobin_boy_name
setcheou	benin_girl_name
hounkanlinkpe	benin_girl_name
alihouessi	benin_girl_name
kinah	nobin_boy_name
jesugo	benin_boy_name
sèton	benin_boy_name
miska	nobin_girl_name
unatti	nobin_girl_name
nolua	nobin_girl_name
mahussenam	benin_girl_name
hammid	nobin_boy_name
hinvi	benin_boy_name
kponon	benin_girl_name
medesse	benin_boy_name
halu	nobin_girl_name
oshallah	nobin_boy_name
selidji	benin_boy_name
mahublo	benin_boy_name
appa	nobin_girl_name
shimmat	nobin_boy_name
ahoboko	benin_boy_name
sâtti	nobin_boy_name
noqod	nobin_boy_name
sessomissou	benin_boy_name
fatou	nobin_girl_name
kinya	nobin_boy_name
selomè	benin_girl_name
hassan	nobin_boy_name
zounon	benin_boy_name
meton	benin_boy_name
munâ	nobin_girl_name
mahusse	benin_boy_name
tognime	benin_boy_name
kemâl	nobin_boy_name
sagbovi	benin_boy_name
iisib	nobin_boy_name
arbaab	nobin_boy_name
houegnongbe	benin_girl_name
fanna	nobin_girl_name
mahoussi	benin_girl_name
yéwonmian	benin_girl_name
tambal	nobin_boy_name
adama	nobin_boy_name
kanhonou	benin_boy_name
sedami	benin_girl_name
kâra	nobin_girl_name
dénangan	benin_boy_name
houénafa	benin_girl_name
dona	benin_girl_name
kpognin	benin_boy_name
hammit	nobin_boy_name
ahogle	benin_boy_name
ketti	nobin_boy_name
amadji	benin_boy_name
meliho	benin_girl_name
tamaya	nobin_girl_name
gbedossou	benin_boy_name
dara	nobin_girl_name
koloda	nobin_boy_name
ehahoun	benin_girl_name
ashri	nobin_girl_name
fatima	nobin_girl_name
fadonon	benin_boy_name
adjakossa	benin_boy_name
sèssédé	benin_boy_name
tirhaqa	nobin_boy_name
aihounzonon	benin_boy_name
samîr	nobin_boy_name
nangnon	benin_boy_name
mahounan	benin_boy_name
amna	nobin_girl_name
tabid	nobin_boy_name
ahowanou	benin_boy_name
mahouenami	benin_girl_name