sègnimètché	mixed_name
zè	benin_city
afɔ	body_part
sovi	boy_name
ahouéfa	girl_name
houndayidji	boy_name
gogotainkpon	benin_city
kinmagba	boy_name
ganvié	benin_city
mahussedeh	mixed_name
dossou-yovo	mixed_name
avivɔsun	month_year
fifamè	girl_name
sèdami	girl_name
zinsou	boy_name
zosun	month_year
afɔkpɑkpɑ	body_part
ndali	benin_city
djimon	boy_name
afiavi	mixed_name
tossa	boy_name
zonon	boy_name
nuxwasun	month_year
aguessi	girl_name
adonon	mixed_name
sessi	girl_name
babatoundji	boy_name
bétérou	benin_city
fifamin	girl_name
vidjinangni	boy_name
sèmèvoh	girl_name
kùtonù	benin_city
ayidosu	month_year
dagbeji	boy_name
denangni	boy_name
gbèdo	boy_name
agbangnizou	benin_city
mehome	boy_name
ahɔnvi	body_part
ayéfèmi	mixed_name
alɔkpɑkpa	body_part
bonon	boy_name
houessinon	mixed_name
houéfa	girl_name
glele	boy_name
athiémè	benin_city
sènanmi	mixed_name
mededode	mixed_name
nũ	body_part
ayaba	girl_name
sibigbe	day_week
akouwègnon	mixed_name
ségbana	benin_city
alogon	mixed_name
ɖɑ	body_part
alịnmɛn	body_part
tạ	body_part
abiola	boy_name
dagbede	boy_name
agonli	benin_city
sessito	girl_name
afɔgokɔ	body_part
alɔvi	body_part
omantayo	mixed_name
sognon	boy_name
assiba	girl_name
abă	body_part
gbètondji	boy_name
ahounanse	girl_name
tonaffa	boy_name
akouvi	girl_name
toovi	mixed_name
tanguiéta	benin_city
azangagbé	day_week
gbèmènou	boy_name
n'venonfon	boy_name
sossou	boy_name
setondji	boy_name
gbegningbenan	mixed_name
gbètognon	mixed_name
zâ-kpota	benin_city
gbenou	boy_name
aglăn	body_part
doupko	mixed_name
mèdéseh	girl_name
fènou	girl_name
hounon	girl_name
kodjovi	boy_name
fifa	girl_name
nɛngbé	body_part
dassa	benin_city
sènan	boy_name
gangnon	boy_name
segla	boy_name
sité	girl_name
houetchegon	mixed_name
woosun	month_year
zofinkplɔsun	month_year
sena	girl_name
houeto	boy_name
akwavi	girl_name
agbomè-kandofi	benin_city
tchenangnon	mixed_name
nonvignon	mixed_name
djossou	boy_name
gbenankpon	boy_name
ouinssi	girl_name
hodonou	boy_name
kouessi	mixed_name
setchégbé	mixed_name
cococodji	benin_city
houesse	girl_name
houenagnon	boy_name
ahossou	boy_name
dossavi	boy_name
dossounon	mixed_name
nobime	mixed_name
gbɑkɔ	body_part
sossa	girl_name
hounsinoun	mixed_name
mahugnon	mixed_name
asɑ	body_part
boukoumbé	benin_city
agbomè	benin_city
aluunsu	month_year
djidja	benin_city
nyɔnuzanbgé	day_week
adjoua	girl_name
orèmi	girl_name
olayinka	mixed_name
akɔnta	body_part
zogụdo	body_part
adetola	boy_name
finagnon	mixed_name
agossou	girl_name
hounon	boy_name
alɔ	body_part
dossi	girl_name
zoungbo-tossota	benin_city
awɔntịn	body_part
comlan	boy_name
tɑxụ	body_part
mahougbé	mixed_name
adjibola	mixed_name
mawuton	mixed_name
kɔ	body_part
grand-popo	benin_city
gahoun	boy_name
ayékotchikpa	mixed_name
pobè	benin_city
sagbo	boy_name
djidonou	boy_name
fidjrosse	benin_city
olouwafoumi	girl_name
vignon	mixed_name
alihonou	boy_name
tchaourou	benin_city
gbedonou	boy_name
fifavi	girl_name
alihossi	girl_name
fossou	boy_name
xwéjisun	month_year
hêvié	benin_city
dansou	boy_name
bohicon	benin_city
tó	body_part
taatagbé	day_week
sakété	benin_city
mehvo	mixed_name
djidjoho	girl_name
gbodja	boy_name
dotou	boy_name
alihossi	mixed_name
kanfonhoue	boy_name
kõli	body_part
liyasun	month_year
somalin	girl_name
mahouton	mixed_name
ablefonlin	mixed_name
affogon	boy_name
mahoume	mixed_name
olamidé	mixed_name
codjo	boy_name
gado	boy_name
dossou	boy_name
houenou	mixed_name
kpatinvoh	mixed_name
kouandé	benin_city
wosun	month_year
toffa	boy_name
kpadonou	boy_name
mahuna	mixed_name
kérou	benin_city
wiceji	boy_name
dansi	girl_name
sezonlin	boy_name
ayo	mixed_name
glessi	girl_name
bidossessi	girl_name
sowanou	girl_name
enangnon	mixed_name
dégbèhi	mixed_name
afɔgbɛnụn	body_part
porga	benin_city
videhouenoun	boy_name
djeregbé	benin_city
gbegan	boy_name
boton	mixed_name
gbedo	mixed_name
jawou	boy_name
houenon	girl_name
foumilayo	girl_name
ahouansou	boy_name
sèhouè	benin_city
koulodji	boy_name
oluwatoyin	girl_name
kpèdétin	girl_name
dégnitché	boy_name
djivede	boy_name
bossou	mixed_name
ahlonsou	girl_name
agla	benin_city
hessou	boy_name
coffi	boy_name
afiwa	girl_name
zɑkɛtɛ	body_part
yonnụn	body_part
sonangon	mixed_name
tɛnigbé	day_week
hountcheme	boy_name
axɔsuzangbé	day_week
akouavi	mixed_name
kèmi	girl_name
akouavi	girl_name
tossa	mixed_name
fifawah	girl_name
houenoun	boy_name
nụnkụn	body_part
sèwanou	girl_name
abɔxwisun	month_year
cossi	boy_name
adjanohoun	girl_name
tossoulegue	girl_name
aklunɔzangbé	day_week
denankpon	mixed_name
yaovi	girl_name
mahuklo	mixed_name
kɔnyasun	month_year
sourou	boy_name
ablawa	girl_name
sèdjro	boy_name
vodungbé	day_week
kandé	girl_name
femi	mixed_name
gbevi	mixed_name
fifonsi	girl_name
nukunxwasun	month_year
mawuena	girl_name
akouègnon	boy_name
coovi	boy_name
binanzon	girl_name
sègla	mixed_name
cocotomè	benin_city
gléxwé	benin_city
mahougnon	mixed_name
kplakou	benin_city
alonoumi	mixed_name
dosse	boy_name
wõgbonou	benin_city
kantchémey	boy_name
xogbonou	benin_city
fifawa	girl_name
mahutin	mixed_name
lidosun	month_year
fɛnvị	body_part
donan	mixed_name
tognon	mixed_name
canãan	benin_city
gbessossou	boy_name
ahouefa	girl_name
adjilé	mixed_name
houefonde	boy_name
tadagbé	boy_name
fadonougbo	boy_name
péhonko	benin_city
eloginisè	girl_name
azovè	benin_city
yenoukoumè	girl_name
mahuton	mixed_name
missèbo	benin_city
sèmanou	boy_name
segbenou	boy_name
ahinon	girl_name
olouwafèmi	mixed_name
afiavi	girl_name
hounyonvi	girl_name
bignon	mixed_name
adɔgo	body_part
anɔn	body_part
hinnougnon	mixed_name
tchegnon	mixed_name
ayaovi	girl_name
gbessi	girl_name
hadonon	mixed_name
sègbégnon	boy_name
dangbo	benin_city
ouèdo	benin_city
taɖèglá	girl_name
nùgbǒnyɔ́	girl_name
akɔ̀nyɔ́	boy_name
sɛ́wɛnɔɖɔ̀	girl_name
jóyěɖó	girl_name
aviɖěmɛǎ	girl_name
sɛ́vímì	boy_name
mawukló	girl_name
akɔ̀nyínú	boy_name
mɩsímawú	boy_name
byɔ́wá	boy_name
nalɔ̀nhǎn	boy_name
ɖagbemabú	boy_name
bìnyɔ́	boy_name
ayìcefá	girl_name
tɔ́jɛ́nnányí	girl_name
gbɛwɛɖɔ̀	girl_name
tɔ́nyɔ́	girl_name
akɔ̀wɛnɔmɔ̀	girl_name
gbɛtɔ́nyɔ́	boy_name
akɔ̀jɛ́nnɔmɔ̀	girl_name
tacemɛ̀	girl_name
ayìmɛvó	girl_name
gbɛtɔ̀nnyɔ́	girl_name
tɔ́námi	girl_name
aɖinyɔ́	boy_name
akɔ̀cenyɔ́	boy_name
sɛ́kpɔ́n	girl_name
tɔ́nyísɛ́	boy_name
ɖagbewatɔ́	girl_name
akpɔ̀ciyě	boy_name
ayiwú	boy_name
gbɛcenyɔ́	boy_name
lusɛ́n	boy_name
kúnáɖuǎ	girl_name
jlǒmawutɔn	girl_name
kpɔ́ngbɛtɔ́	girl_name
alɔsɔ́	girl_name
jǒbinúgbɛ̀	girl_name
kpɔɖègbè	boy_name
lanmalyá	boy_name
dɛ̀cegbè	girl_name
sɛ́númátɛ̀n	girl_name
mɛdétɔ̀nhǎn	girl_name
kúnyíceà	girl_name
letɔnɖè	boy_name
sɛ́tɔ̀njí	girl_name
sɛ́núwa	boy_name
letɔnɖotè	boy_name
ɖagbè	boy_name
alɔcejí	girl_name
jokɛndó	girl_name
kúɖémɛ̀ǎ	boy_name
dɛ̀húbǒ	girl_name
ɖagbenyɔ́	girl_name
jòxódó	girl_name
alɔkpɔ́n	girl_name
bǐɖòsɛ́sí	boy_name
kánnábuǎ	boy_name
mɔ̌sɛ́dé	boy_name
tacegbè	girl_name
akpɔ̀cikɛ̀n	boy_name
gbɛwɛnɔsɔ́	boy_name
avǐnyíceǎ	girl_name
sɛ́xámi	boy_name
sɔmázégekpɔ́	girl_name
ayífá	boy_name
vísè	boy_name
nǔnyɔ́	boy_name
bǐjɛ́nnányɔ́	boy_name
ayícevó	boy_name
mawugbɛ́	boy_name
gbeceɖì	girl_name
kɛnnyígbɛ̀ǎ	girl_name
mawusí	boy_name
kpɔgbè	boy_name
tɔ́ɖɔ̀mɔ̌	boy_name
gbɛ̀nyɔ́	boy_name
nájɛ̀nyìɖé	boy_name
éhúzú	girl_name
tlíjì	boy_name
kúncemɛ̀	girl_name
mɛɖémɛ̀	girl_name
eglókɛ̀n	boy_name
tɔ́gbèjí	girl_name
núgbǒ	boy_name
kpɔɖólǒ	girl_name
mawujlǒ	boy_name
eglóbǒ	girl_name
nǔnyímɔ̌	boy_name
taɖògbɛ̀	boy_name
sɛ́ɖɔ̀ǎ	girl_name
nàɖónyí	boy_name
nàtɛ́nkpɔ́n	boy_name
sɛ́gbè	boy_name
nyɔ̌xlɛ́	girl_name
nyɔ̌wà	boy_name
aditi	girl_name
sɛ́wɛɖɔ̀	girl_name
yisé	boy_name
sɛ́dónǔ	girl_name
cejɛnnányí	girl_name
gbèyětɔn	girl_name
cenyíkpɛ́	girl_name
ayínyɔ́	boy_name
cenyɔ́	boy_name
mawuná	boy_name
ayíjɛ́nlǒhɛ̀n	boy_name
mawutɔ́njí	girl_name
mɛ̀bǐmɛcè	girl_name
ayíjɛ́nlǒɖó	boy_name
malɔnwó	boy_name
cenjɛnnáhú	girl_name
sɛ́síwɛ́ɖè	boy_name
dǒvɛ̀núyě	boy_name
ayícemɔ̀	boy_name
mɛ́nyísù	girl_name
sɛ́nálɔ̀nhǎn	girl_name
dǒvɛ̀núkɛ̀n	boy_name
sɛ́mɛ́vò	girl_name
ayísɔ́	girl_name
dònǎ	boy_name
jònúgbɛ̀	girl_name
nyígbɛ̀sù	boy_name
akɔjí	boy_name
sɛ́tɔ̀n	boy_name
gbɛndágbà	girl_name
dɛcedomɛ̀	girl_name
kɛnnámɔ̀ǎ	girl_name
doyigbè	girl_name
tinbókpɔ́n	boy_name
tɔ́yɛ̀mɛ̀	girl_name
hɛnnyícèá	boy_name
sɛ́céglá	boy_name
jezugbɛ́	boy_name
alɔ̀mablógbɛ́ɖó	boy_name
taɖagbè	boy_name
sɛ́ɖùǎ	boy_name
dɛnyísù	boy_name
fɛ́núɖè	boy_name
hwecenú	boy_name
azǎnɖegbè	boy_name
kɛnwunmɛ̀	girl_name
sɛ́tɔ̀nnyɔ́	girl_name
hwɛmitɔnwɛ̀ǎ	boy_name
jònúsɛ́	girl_name
azǎntɔ̀ngbè	girl_name
hwenusù	girl_name
tɔ́ceyɛ̀mɛ̀	girl_name
aɖǎnɖòsɛ́sí	boy_name
dɛ̀domɛ̀	girl_name
fifá	boy_name
tɔ́domɛ̀	girl_name
hwecewɛhún	girl_name
vínásè	boy_name
gbɛndún	girl_name
mawukoná	girl_name
vínyígbɛ̀	girl_name
yɛ̀yǐmɛ̀	girl_name
sɛ́ylɔ́mì	boy_name
akɔxó	boy_name
vínyíkɛ̀n	girl_name
sɛ́tɔ́nwɛ̀	girl_name
alɔwú	girl_name
mawunyɔ́	girl_name
víjɛnnɔ́nyí	boy_name
gbɛ̀kpɔ́n	girl_name
tɔ́cɛ́mɛ̀	boy_name
vílɔ́nnǔ	boy_name
gbɛ̀tɔ́nnyínǔgbó	girl_name
sɛ́ɖégbè	boy_name
minyìgbɛ̀sù	girl_name
gbɛ̀ceɖòyěsiǎ	girl_name
tɔ́fɔ́jí	girl_name
háɖényɔ́númɛɖé	boy_name
sɛ́nálɔ̀nhǎn	boy_name
mákpɔ́nsɛ́	girl_name
víɖémɛ̀	boy_name
gbɛ̀tɔ́jɛ́nnányí	girl_name
mɛtɔ́ɖɛ̀	girl_name
mɔ̌sɛ́ɖé	girl_name
jivɛ́ɖè	boy_name
unnálɔ̀nhǎn	boy_name
tacenyɔ́	boy_name
háɖémɛ̀	boy_name
tɔ́nyíɖì	boy_name
jezuví	girl_name
jezunyɔ́	boy_name
ungbɛ́xó	boy_name
hwenukodínhǎn	boy_name
bǒɖéɖèǎ	girl_name
vínyɔ́	boy_name
tɔ́nyínáɖì	girl_name
hwecehùn	boy_name
fínyɔ́númì	girl_name
dejɛ́nlǒɖó	girl_name
tɔ́námɛ̀	girl_name
kúncenyɔ́	boy_name
jezulɔ́mɛ̀	boy_name
ɖagbèliji	girl_name
jezukló	boy_name
jezúná	boy_name
dɛnyɔ́	girl_name
tɔ́xwényɔ́	girl_name
hɛ̌nɖémɛ̀ǎ	boy_name
víjɛ́nnɔmɔ̀	girl_name
unglǒbǒ	girl_name
ɖagbèwá	girl_name
wìnúmì	boy_name
xwéfá	boy_name
nɛ̌lǒnɔ̀	girl_name
ɖagbèsɛ́	girl_name
víɖòtè	girl_name
taceglá	boy_name
fɛ́nú	boy_name
mɛ́ɖékɔ̀n	boy_name
gbɛdágbà	girl_name
mɛɖésɛ́	boy_name
ényɔ́númì	girl_name
gbɛfá	girl_name
azɔnnyíceǎ	boy_name
tamɛnyɔ́	boy_name
gbɛkpò	girl_name
vivò	boy_name
sɛ́kpɔ́nmì	girl_name
waɖáyǐ	boy_name
gbɛnyíbǒǎ	boy_name
tanyɔ́	boy_name
gbɛnáyíǎ	girl_name
tɔ́nyínájɛ̀	girl_name
cejɛnnáhú	girl_name
sɛ́náɖě	boy_name
kɛ̀nɖìá	girl_name
mawugbè	girl_name
sɛ́lijí	girl_name
gbɛwɛtò	boy_name
aděhlenyà	boy_name
mɛɖétunwunhǎn	boy_name
sɛ́dó	boy_name
minámɔǎ	girl_name
tɔ́nyíjɛ̀	boy_name
nɔdomɛ̀	boy_name
tɔ́cenyɔ́	girl_name
sɛ́nyikɔkpɔ́nmì	boy_name
sɛ́ɖékɔ̀n	girl_name
gbɛflínmì	boy_name
fɛnkpɔ́n	girl_name
sɛ́núwɛ̀	girl_name
naégbè	girl_name
gbɛví	boy_name
sɛ́másà	girl_name
vivomɛ̀	girl_name
sɛ́gàn	boy_name
sɛ́ɖó	girl_name
alɔmasɛ́gbɛdó	boy_name
sɛ́xówɛ̀	girl_name
nyǐcénábúǎ	boy_name
gbɛtɔ́jɛ́nnɔmɔ̀	boy_name
gbɛnyímɛɖétɔ̀nhǎn	girl_name
sɛ́gbɛ́yà	boy_name
enyɔ́	boy_name
sɛ́gànmɛ̀	boy_name
mɛɖagbè	boy_name
vivonyɔ́	boy_name
sɛ́máyí	boy_name
