Shigirti	body_parts
Ur	body_parts
Mâgn	body_parts
Ukki	body_parts
Soriģ	body_parts
Ag	body_parts
Kakram	body_parts
Sâmê	body_parts
Gumur	body_parts
Esmar	body_parts
Og	body_parts
kurti	body_parts
Duģussi	body_parts
Eddi	body_parts
Kul	body_parts
Eddi-na-sarbê	body_parts
fokki	body_parts
nar	body_parts
fûd	body_parts
nîd	body_parts
tû	body_parts
kerma	nobian_city
dongolâ	nobian_city
merowê	nobian_city
napata	nobian_city
tabajî	nobian_city
nurî	nobian_city
El-kurru	nobian_city
sedeinga	nobian_city
shât	nobian_city
toshka	nobian_city
abrî	nobian_city
wâwâ	nobian_city
semnâ	nobian_city
delgô	nobian_city
kawa	nobian_city
kinah	boys_name
Samîr	boys_name
Hammit	boys_name
Umar	boys_name
Hammid	boys_name
hassan	boys_name
ketti	boys_name
kinya	boys_name
kemâl	boys_name
tabid	boys_name
tambal	boys_name
oshallah	boys_name
shihali	boys_name
shimmat	boys_name
arbaab	boys_name
Iisib	boys_name
koloda	boys_name
oshi	boys_name
adama	boys_name
tirhaqa	boys_name
noqod	boys_name
sâtti	boys_name
sâlah	boys_name
sorkatti	boys_name
Munâ	girls_name
Majdolên	girls_name
amna	girls_name
fatima	girls_name
amaros	girls_name
Nabra	girls_name
fanna	girls_name
fatou	girls_name
osha	girls_name
tamâya	girls_name
ashri	girls_name
miska	girls_name
kâra	girls_name
nolua	girls_name
dara	girls_name
daria	girls_name
duwana	girls_name
appa	girls_name
winji	girls_name
sela	girls_name
halu	girls_name
ashri	girls_name
miska	girls_name
unatti	girls_name