amna	girl_name
shimmat	boy_name
fatou	girl_name
majdolên	girl_name
arbaab	boy_name
noqod	boy_name
fanna	girl_name
shihali	boy_name
miska	girl_name
hammit	boy_name
tambal	boy_name
nabra	girl_name
samîr	boy_name
tabid	boy_name
tamaya	girl_name
umar	boy_name
tirhaqa	boy_name
iisib	boy_name
dara	girl_name
oshallah	boy_name
sâtti	boy_name
duwana	girl_name
unatti	girl_name
halu	girl_name
kinah	boy_name
fatima	girl_name
sâlah	boy_name
osha	girl_name
nolua	girl_name
kinya	boy_name
ashri	girl_name
munâ	girl_name
koloda	boy_name
hassan	boy_name
amaros	girl_name
daria	girl_name
kâra	girl_name
oshi	boy_name
hammid	boy_name
kemâl	boy_name
sela	girl_name
adama	boy_name
appa	girl_name
winji	girl_name
ketti	boy_name
